location,date,new_diagnoses,cum_infections,new_deaths,cum_deaths,new_tests,cum_tests,imported_cases
Guadalajara,2019-12-31,0,0,0,0,0,0,1
Guadalajara,2020-01-01,0,0,0,0,0,0,1
Guadalajara,2020-01-02,0,0,0,0,0,0,1
Guadalajara,2020-01-03,0,0,0,0,1,1,1
Guadalajara,2020-01-04,0,0,0,0,0,1,1
Guadalajara,2020-01-05,0,0,0,0,1,2,1
Guadalajara,2020-01-06,0,0,0,0,1,3,1
Guadalajara,2020-01-07,0,0,0,0,1,4,1
Guadalajara,2020-01-08,0,0,0,0,2,6,1
Guadalajara,2020-01-09,0,0,0,0,6,12,1
Guadalajara,2020-01-10,0,0,0,0,7,19,1
Guadalajara,2020-01-11,0,0,0,0,0,19,1
Guadalajara,2020-01-12,0,0,0,0,2,21,1
Guadalajara,2020-01-13,0,0,0,0,6,27,1
Guadalajara,2020-01-14,0,0,0,0,5,32,1
Guadalajara,2020-01-15,0,0,0,0,6,38,1
Guadalajara,2020-01-16,0,0,0,0,5,43,1
Guadalajara,2020-01-17,0,0,0,0,7,50,1
Guadalajara,2020-01-18,0,0,0,0,3,53,1
Guadalajara,2020-01-19,0,0,0,0,0,53,1
Guadalajara,2020-01-20,0,0,0,0,8,61,1
Guadalajara,2020-01-21,0,0,0,0,6,67,1
Guadalajara,2020-01-22,0,0,0,0,6,73,1
Guadalajara,2020-01-23,0,0,0,0,4,77,1
Guadalajara,2020-01-24,0,0,0,0,1,78,1
Guadalajara,2020-01-25,0,0,0,0,2,80,1
Guadalajara,2020-01-26,0,0,0,0,3,83,1
Guadalajara,2020-01-27,0,0,0,0,4,87,1
Guadalajara,2020-01-28,0,0,0,0,1,88,1
Guadalajara,2020-01-29,0,0,0,0,5,93,1
Guadalajara,2020-01-30,0,0,0,0,4,97,1
Guadalajara,2020-01-31,0,0,0,0,4,101,1
Guadalajara,2020-02-01,0,0,0,0,0,101,1
Guadalajara,2020-02-02,0,0,0,0,1,102,1
Guadalajara,2020-02-03,0,0,0,0,2,104,1
Guadalajara,2020-02-04,0,0,0,0,2,106,1
Guadalajara,2020-02-05,0,0,0,0,4,110,1
Guadalajara,2020-02-06,0,0,0,0,4,114,1
Guadalajara,2020-02-07,0,0,0,0,0,114,1
Guadalajara,2020-02-08,0,0,0,0,1,115,1
Guadalajara,2020-02-09,0,0,0,0,1,116,1
Guadalajara,2020-02-10,0,0,0,0,3,119,1
Guadalajara,2020-02-11,0,0,0,0,2,121,1
Guadalajara,2020-02-12,0,0,0,0,3,124,1
Guadalajara,2020-02-13,0,0,0,0,7,131,1
Guadalajara,2020-02-14,0,0,0,0,2,133,1
Guadalajara,2020-02-15,0,0,0,0,0,133,1
Guadalajara,2020-02-16,0,0,0,0,0,133,1
Guadalajara,2020-02-17,0,0,0,0,2,135,1
Guadalajara,2020-02-18,0,0,0,0,1,136,1
Guadalajara,2020-02-19,0,0,0,0,3,139,1
Guadalajara,2020-02-20,0,0,0,0,2,141,1
Guadalajara,2020-02-21,0,0,0,0,3,144,1
Guadalajara,2020-02-22,0,0,0,0,1,145,1
Guadalajara,2020-02-23,0,0,0,0,0,145,1
Guadalajara,2020-02-24,0,0,0,0,2,147,1
Guadalajara,2020-02-25,0,0,0,0,0,147,1
Guadalajara,2020-02-26,0,0,0,0,2,149,1
Guadalajara,2020-02-27,0,0,0,0,2,151,1
Guadalajara,2020-02-28,0,0,0,0,1,152,1
Guadalajara,2020-02-29,0,0,0,0,2,154,1
Guadalajara,2020-03-01,0,0,0,0,1,155,1
Guadalajara,2020-03-02,0,0,0,0,5,160,1
Guadalajara,2020-03-03,0,0,0,0,2,162,1
Guadalajara,2020-03-04,0,0,0,0,2,164,1
Guadalajara,2020-03-05,0,0,0,0,2,166,1
Guadalajara,2020-03-06,0,0,0,0,1,167,1
Guadalajara,2020-03-07,0,0,0,0,0,167,1
Guadalajara,2020-03-08,0,0,0,0,1,168,1
Guadalajara,2020-03-09,0,0,0,0,1,169,1
Guadalajara,2020-03-10,0,0,0,0,3,172,1
Guadalajara,2020-03-11,1,1,0,0,3,175,1
Guadalajara,2020-03-12,1,2,0,0,3,178,1
Guadalajara,2020-03-13,0,2,0,0,6,184,1
Guadalajara,2020-03-14,2,4,0,0,3,187,1
Guadalajara,2020-03-15,2,6,0,0,3,190,1
Guadalajara,2020-03-16,6,12,0,0,10,200,1
Guadalajara,2020-03-17,3,15,0,0,13,213,1
Guadalajara,2020-03-18,3,18,0,0,20,233,1
Guadalajara,2020-03-19,6,24,0,0,26,259,1
Guadalajara,2020-03-20,3,27,1,1,13,272,1
Guadalajara,2020-03-21,0,27,0,1,3,275,1
Guadalajara,2020-03-22,0,27,0,1,8,283,1
Guadalajara,2020-03-23,0,27,0,1,31,314,1
Guadalajara,2020-03-24,0,27,0,1,25,339,1
Guadalajara,2020-03-25,1,28,0,1,42,381,1
Guadalajara,2020-03-26,5,33,0,1,24,405,1
Guadalajara,2020-03-27,3,36,0,1,40,445,1
Guadalajara,2020-03-28,0,36,0,1,14,459,1
Guadalajara,2020-03-29,1,37,0,1,18,477,1
Guadalajara,2020-03-30,3,40,0,1,38,515,1
Guadalajara,2020-03-31,2,42,0,1,33,548,1
Guadalajara,2020-04-01,1,43,0,1,30,578,1
Guadalajara,2020-04-02,3,46,0,1,32,610,1
Guadalajara,2020-04-03,4,50,0,1,43,653,1
Guadalajara,2020-04-04,0,50,0,1,19,672,1
Guadalajara,2020-04-05,0,50,0,1,17,689,1
Guadalajara,2020-04-06,2,52,0,1,35,724,1
Guadalajara,2020-04-07,1,53,0,1,43,767,1
Guadalajara,2020-04-08,5,58,0,1,38,805,1
Guadalajara,2020-04-09,0,58,0,1,16,821,1
Guadalajara,2020-04-10,3,61,1,2,19,840,1
Guadalajara,2020-04-11,0,61,0,2,21,861,1
Guadalajara,2020-04-12,1,62,0,2,8,869,1
Guadalajara,2020-04-13,4,66,0,2,35,904,1
Guadalajara,2020-04-14,2,68,0,2,30,934,1
Guadalajara,2020-04-15,1,69,0,2,25,959,1
Guadalajara,2020-04-16,1,70,1,3,29,988,1
Guadalajara,2020-04-17,3,73,0,3,36,1024,1
Guadalajara,2020-04-18,1,74,0,3,25,1049,0
Guadalajara,2020-04-19,1,75,0,3,8,1057,0
Guadalajara,2020-04-20,0,75,0,3,60,1117,0
Guadalajara,2020-04-21,8,83,0,3,57,1174,0
Guadalajara,2020-04-22,2,85,0,3,55,1229,0
Guadalajara,2020-04-23,4,89,0,3,47,1276,0
Guadalajara,2020-04-24,7,96,2,5,74,1350,0
Guadalajara,2020-04-25,3,99,0,5,27,1377,0
Guadalajara,2020-04-26,3,102,0,5,17,1394,0
Guadalajara,2020-04-27,3,105,1,6,41,1435,0
Guadalajara,2020-04-28,2,107,0,6,26,1461,0
Guadalajara,2020-04-29,6,113,0,6,47,1508,0
Guadalajara,2020-04-30,5,118,2,8,27,1535,0
Guadalajara,2020-05-01,5,123,0,8,48,1583,0
Guadalajara,2020-05-02,11,134,3,11,37,1620,0
Guadalajara,2020-05-03,4,138,0,11,15,1635,0
Guadalajara,2020-05-04,13,151,1,12,67,1702,0
Guadalajara,2020-05-05,3,154,1,13,29,1731,0
Guadalajara,2020-05-06,4,158,3,16,48,1779,0
Guadalajara,2020-05-07,15,173,1,17,57,1836,0
Guadalajara,2020-05-08,8,181,0,17,54,1890,0
Guadalajara,2020-05-09,8,189,1,18,47,1937,0
Guadalajara,2020-05-10,9,198,2,20,28,1965,0
Guadalajara,2020-05-11,12,210,1,21,80,2045,0
Guadalajara,2020-05-12,7,217,3,24,46,2091,0
Guadalajara,2020-05-13,10,227,1,25,60,2151,0
Guadalajara,2020-05-14,17,244,1,26,71,2222,0
Guadalajara,2020-05-15,10,254,3,29,90,2312,0
Guadalajara,2020-05-16,7,261,5,34,53,2365,0
Guadalajara,2020-05-17,13,274,3,37,38,2403,0
Guadalajara,2020-05-18,21,295,2,39,89,2492,0
Guadalajara,2020-05-19,19,314,0,39,69,2561,0
Guadalajara,2020-05-20,22,336,1,40,82,2643,0
Guadalajara,2020-05-21,22,358,2,42,100,2743,0
Guadalajara,2020-05-22,25,383,0,42,92,2835,0
Guadalajara,2020-05-23,13,396,3,45,51,2886,0
Guadalajara,2020-05-24,20,416,1,46,40,2926,0
Guadalajara,2020-05-25,31,447,3,49,117,3043,0
Guadalajara,2020-05-26,29,476,0,49,101,3144,0
Guadalajara,2020-05-27,49,525,1,50,121,3265,0
Guadalajara,2020-05-28,38,563,1,51,126,3391,0
Guadalajara,2020-05-29,60,623,2,53,143,3534,0
Guadalajara,2020-05-30,40,663,6,59,102,3636,0
Guadalajara,2020-05-31,25,688,2,61,54,3690,0
Guadalajara,2020-06-01,73,761,6,67,150,3840,0
Guadalajara,2020-06-02,49,810,5,72,140,3980,0
Guadalajara,2020-06-03,70,880,8,80,157,4137,0
Guadalajara,2020-06-04,49,929,10,90,139,4276,0
Guadalajara,2020-06-05,64,993,5,95,162,4438,0
Guadalajara,2020-06-06,38,1031,7,102,89,4527,0
Guadalajara,2020-06-07,18,1049,11,113,45,4572,0
Guadalajara,2020-06-08,87,1136,4,117,180,4752,0
Guadalajara,2020-06-09,68,1204,6,123,158,4910,0
Guadalajara,2020-06-10,61,1265,7,130,164,5074,0
Guadalajara,2020-06-11,45,1310,7,137,167,5241,0
Guadalajara,2020-06-12,32,1342,9,146,137,5378,0
Guadalajara,2020-06-13,18,1360,4,150,80,5458,0
Guadalajara,2020-06-14,18,1378,8,158,52,5510,0
Guadalajara,2020-06-15,23,1401,5,163,151,5661,0
Guadalajara,2020-06-16,2,1403,2,165,139,5800,0
Guadalajara,2020-06-17,2,1405,0,165,107,5907,0
Merida,2019-12-31,0,0,0,0,0,0,1
Merida,2020-01-01,0,0,0,0,0,0,1
Merida,2020-01-02,0,0,0,0,0,0,1
Merida,2020-01-03,0,0,0,0,0,0,1
Merida,2020-01-04,0,0,0,0,0,0,1
Merida,2020-01-05,0,0,0,0,0,0,1
Merida,2020-01-06,0,0,0,0,0,0,1
Merida,2020-01-07,0,0,0,0,0,0,1
Merida,2020-01-08,0,0,0,0,0,0,1
Merida,2020-01-09,0,0,0,0,1,1,1
Merida,2020-01-10,0,0,0,0,0,1,1
Merida,2020-01-11,0,0,0,0,0,1,1
Merida,2020-01-12,0,0,0,0,0,1,1
Merida,2020-01-13,0,0,0,0,0,1,1
Merida,2020-01-14,0,0,0,0,0,1,1
Merida,2020-01-15,0,0,0,0,0,1,1
Merida,2020-01-16,0,0,0,0,0,1,1
Merida,2020-01-17,0,0,0,0,0,1,1
Merida,2020-01-18,0,0,0,0,0,1,1
Merida,2020-01-19,0,0,0,0,0,1,1
Merida,2020-01-20,0,0,0,0,1,2,1
Merida,2020-01-21,0,0,0,0,1,3,1
Merida,2020-01-22,0,0,0,0,0,3,1
Merida,2020-01-23,0,0,0,0,2,5,1
Merida,2020-01-24,0,0,0,0,0,5,1
Merida,2020-01-25,0,0,0,0,0,5,1
Merida,2020-01-26,0,0,0,0,0,5,1
Merida,2020-01-27,0,0,0,0,0,5,1
Merida,2020-01-28,0,0,0,0,1,6,1
Merida,2020-01-29,0,0,0,0,0,6,1
Merida,2020-01-30,0,0,0,0,0,6,1
Merida,2020-01-31,0,0,0,0,0,6,1
Merida,2020-02-01,0,0,0,0,0,6,1
Merida,2020-02-02,0,0,0,0,0,6,1
Merida,2020-02-03,0,0,0,0,0,6,1
Merida,2020-02-04,0,0,0,0,1,7,1
Merida,2020-02-05,0,0,0,0,0,7,1
Merida,2020-02-06,0,0,0,0,2,9,1
Merida,2020-02-07,0,0,0,0,0,9,1
Merida,2020-02-08,0,0,0,0,0,9,1
Merida,2020-02-09,0,0,0,0,0,9,1
Merida,2020-02-10,0,0,0,0,0,9,1
Merida,2020-02-11,0,0,0,0,1,10,1
Merida,2020-02-12,0,0,0,0,0,10,1
Merida,2020-02-13,0,0,0,0,0,10,1
Merida,2020-02-14,0,0,0,0,0,10,1
Merida,2020-02-15,0,0,0,0,0,10,1
Merida,2020-02-16,0,0,0,0,0,10,1
Merida,2020-02-17,0,0,0,0,0,10,1
Merida,2020-02-18,0,0,0,0,0,10,1
Merida,2020-02-19,0,0,0,0,1,11,1
Merida,2020-02-20,0,0,0,0,0,11,1
Merida,2020-02-21,0,0,0,0,1,12,1
Merida,2020-02-22,0,0,0,0,0,12,1
Merida,2020-02-23,0,0,0,0,0,12,1
Merida,2020-02-24,0,0,0,0,0,12,1
Merida,2020-02-25,0,0,0,0,0,12,1
Merida,2020-02-26,0,0,0,0,0,12,1
Merida,2020-02-27,0,0,0,0,0,12,1
Merida,2020-02-28,0,0,0,0,0,12,1
Merida,2020-02-29,0,0,0,0,0,12,1
Merida,2020-03-01,0,0,0,0,1,13,1
Merida,2020-03-02,0,0,0,0,3,16,1
Merida,2020-03-03,0,0,0,0,4,20,1
Merida,2020-03-04,0,0,0,0,0,20,1
Merida,2020-03-05,0,0,0,0,6,26,1
Merida,2020-03-06,0,0,0,0,0,26,1
Merida,2020-03-07,0,0,0,0,1,27,1
Merida,2020-03-08,0,0,0,0,0,27,1
Merida,2020-03-09,0,0,0,0,1,28,1
Merida,2020-03-10,0,0,0,0,1,29,1
Merida,2020-03-11,0,0,0,0,0,29,1
Merida,2020-03-12,1,1,0,0,5,34,1
Merida,2020-03-13,0,1,0,0,1,35,1
Merida,2020-03-14,0,1,0,0,1,36,1
Merida,2020-03-15,4,5,0,0,10,46,1
Merida,2020-03-16,2,7,0,0,5,51,1
Merida,2020-03-17,6,13,0,0,11,62,1
Merida,2020-03-18,0,13,0,0,10,72,1
Merida,2020-03-19,2,15,0,0,13,85,1
Merida,2020-03-20,6,21,0,0,25,110,1
Merida,2020-03-21,0,21,0,0,9,119,1
Merida,2020-03-22,7,28,0,0,17,136,1
Merida,2020-03-23,5,33,0,0,29,165,1
Merida,2020-03-24,8,41,0,0,30,195,1
Merida,2020-03-25,3,44,0,0,17,212,1
Merida,2020-03-26,0,44,0,0,8,220,1
Merida,2020-03-27,2,46,0,0,15,235,1
Merida,2020-03-28,2,48,0,0,12,247,1
Merida,2020-03-29,2,50,0,0,14,261,1
Merida,2020-03-30,10,60,0,0,28,289,1
Merida,2020-03-31,3,63,0,0,21,310,1
Merida,2020-04-01,7,70,0,0,31,341,1
Merida,2020-04-02,2,72,0,0,35,376,1
Merida,2020-04-03,7,79,2,2,34,410,1
Merida,2020-04-04,1,80,0,2,18,428,1
Merida,2020-04-05,4,84,0,2,16,444,1
Merida,2020-04-06,9,93,1,3,27,471,1
Merida,2020-04-07,10,103,0,3,31,502,1
Merida,2020-04-08,8,111,0,3,34,536,1
Merida,2020-04-09,8,119,0,3,23,559,1
Merida,2020-04-10,3,122,0,3,23,582,1
Merida,2020-04-11,5,127,0,3,16,598,1
Merida,2020-04-12,5,132,0,3,17,615,1
Merida,2020-04-13,16,148,1,4,56,671,1
Merida,2020-04-14,13,161,0,4,45,716,1
Merida,2020-04-15,22,183,3,7,43,759,1
Merida,2020-04-16,9,192,1,8,29,788,1
Merida,2020-04-17,10,202,0,8,40,828,1
Merida,2020-04-18,4,206,0,8,15,843,0
Merida,2020-04-19,5,211,1,9,37,880,0
Merida,2020-04-20,16,227,1,10,50,930,0
Merida,2020-04-21,12,239,1,11,38,968,0
Merida,2020-04-22,11,250,1,12,35,1003,0
Merida,2020-04-23,16,266,2,14,54,1057,0
Merida,2020-04-24,19,285,0,14,45,1102,0
Merida,2020-04-25,16,301,1,15,30,1132,0
Merida,2020-04-26,14,315,1,16,18,1150,0
Merida,2020-04-27,19,334,0,16,91,1241,0
Merida,2020-04-28,19,353,0,16,59,1300,0
Merida,2020-04-29,18,371,2,18,75,1375,0
Merida,2020-04-30,25,396,0,18,55,1430,0
Merida,2020-05-01,11,407,2,20,26,1456,0
Merida,2020-05-02,17,424,2,22,26,1482,0
Merida,2020-05-03,10,434,2,24,39,1521,0
Merida,2020-05-04,31,465,2,26,85,1606,0
Merida,2020-05-05,20,485,2,28,55,1661,0
Merida,2020-05-06,20,505,2,30,58,1719,0
Merida,2020-05-07,16,521,1,31,67,1786,0
Merida,2020-05-08,15,536,0,31,52,1838,0
Merida,2020-05-09,8,544,1,32,19,1857,0
Merida,2020-05-10,10,554,3,35,30,1887,0
Merida,2020-05-11,23,577,3,38,71,1958,0
Merida,2020-05-12,26,603,3,41,64,2022,0
Merida,2020-05-13,36,639,2,43,69,2091,0
Merida,2020-05-14,35,674,4,47,68,2159,0
Merida,2020-05-15,22,696,0,47,47,2206,0
Merida,2020-05-16,14,710,2,49,27,2233,0
Merida,2020-05-17,24,734,1,50,39,2272,0
Merida,2020-05-18,33,767,2,52,78,2350,0
Merida,2020-05-19,28,795,2,54,67,2417,0
Merida,2020-05-20,36,831,7,61,71,2488,0
Merida,2020-05-21,36,867,1,62,76,2564,0
Merida,2020-05-22,27,894,3,65,66,2630,0
Merida,2020-05-23,21,915,5,70,35,2665,0
Merida,2020-05-24,18,933,1,71,35,2700,0
Merida,2020-05-25,38,971,6,77,79,2779,0
Merida,2020-05-26,27,998,6,83,68,2847,0
Merida,2020-05-27,44,1042,3,86,80,2927,0
Merida,2020-05-28,27,1069,3,89,45,2972,0
Merida,2020-05-29,28,1097,4,93,73,3045,0
Merida,2020-05-30,15,1112,3,96,36,3081,0
Merida,2020-05-31,11,1123,4,100,30,3111,0
Merida,2020-06-01,36,1159,7,107,73,3184,0
Merida,2020-06-02,30,1189,4,111,48,3232,0
Merida,2020-06-03,31,1220,2,113,58,3290,0
Merida,2020-06-04,21,1241,2,115,36,3326,0
Merida,2020-06-05,21,1262,0,115,33,3359,0
Merida,2020-06-06,31,1293,3,118,55,3414,0
Merida,2020-06-07,22,1315,2,120,35,3449,0
Merida,2020-06-08,40,1355,2,122,86,3535,0
Merida,2020-06-09,37,1392,3,125,63,3598,0
Merida,2020-06-10,31,1423,6,131,72,3670,0
Merida,2020-06-11,32,1455,1,132,86,3756,0
Merida,2020-06-12,30,1485,2,134,70,3826,0
Merida,2020-06-13,17,1502,1,135,40,3866,0
Merida,2020-06-14,28,1530,4,139,56,3922,0
Merida,2020-06-15,28,1558,5,144,82,4004,0
Merida,2020-06-16,9,1567,2,146,86,4090,0
Merida,2020-06-17,0,1567,0,146,30,4120,0
Mexico city,2019-12-31,0,0,0,0,0,0,10
Mexico city,2020-01-01,0,0,0,0,0,0,10
Mexico city,2020-01-02,0,0,0,0,10,10,10
Mexico city,2020-01-03,0,0,0,0,6,16,10
Mexico city,2020-01-04,0,0,0,0,1,17,10
Mexico city,2020-01-05,0,0,0,0,3,20,10
Mexico city,2020-01-06,0,0,0,0,11,31,10
Mexico city,2020-01-07,0,0,0,0,6,37,10
Mexico city,2020-01-08,0,0,0,0,4,41,10
Mexico city,2020-01-09,0,0,0,0,13,54,10
Mexico city,2020-01-10,0,0,0,0,14,68,10
Mexico city,2020-01-11,0,0,0,0,1,69,10
Mexico city,2020-01-12,0,0,0,0,3,72,10
Mexico city,2020-01-13,0,0,0,0,10,82,10
Mexico city,2020-01-14,0,0,0,0,16,98,10
Mexico city,2020-01-15,0,0,0,0,10,108,10
Mexico city,2020-01-16,0,0,0,0,10,118,10
Mexico city,2020-01-17,0,0,0,0,11,129,10
Mexico city,2020-01-18,0,0,0,0,1,130,10
Mexico city,2020-01-19,0,0,0,0,6,136,10
Mexico city,2020-01-20,0,0,0,0,12,148,10
Mexico city,2020-01-21,0,0,0,0,10,158,10
Mexico city,2020-01-22,0,0,0,0,8,166,10
Mexico city,2020-01-23,0,0,0,0,10,176,10
Mexico city,2020-01-24,0,0,0,0,11,187,10
Mexico city,2020-01-25,0,0,0,0,2,189,10
Mexico city,2020-01-26,0,0,0,0,13,202,10
Mexico city,2020-01-27,0,0,0,0,6,208,10
Mexico city,2020-01-28,0,0,0,0,9,217,10
Mexico city,2020-01-29,0,0,0,0,3,220,10
Mexico city,2020-01-30,0,0,0,0,6,226,10
Mexico city,2020-01-31,0,0,0,0,4,230,10
Mexico city,2020-02-01,0,0,0,0,0,230,10
Mexico city,2020-02-02,0,0,0,0,0,230,10
Mexico city,2020-02-03,0,0,0,0,0,230,10
Mexico city,2020-02-04,0,0,0,0,11,241,10
Mexico city,2020-02-05,0,0,0,0,11,252,10
Mexico city,2020-02-06,0,0,0,0,2,254,10
Mexico city,2020-02-07,0,0,0,0,5,259,10
Mexico city,2020-02-08,0,0,0,0,1,260,10
Mexico city,2020-02-09,0,0,0,0,5,265,10
Mexico city,2020-02-10,0,0,0,0,17,282,10
Mexico city,2020-02-11,0,0,0,0,7,289,10
Mexico city,2020-02-12,0,0,0,0,3,292,10
Mexico city,2020-02-13,0,0,0,0,4,296,10
Mexico city,2020-02-14,0,0,0,0,6,302,10
Mexico city,2020-02-15,0,0,0,0,2,304,10
Mexico city,2020-02-16,0,0,0,0,1,305,10
Mexico city,2020-02-17,0,0,0,0,3,308,10
Mexico city,2020-02-18,0,0,0,0,3,311,10
Mexico city,2020-02-19,0,0,0,0,3,314,10
Mexico city,2020-02-20,0,0,0,0,1,315,10
Mexico city,2020-02-21,0,0,0,0,6,321,10
Mexico city,2020-02-22,0,0,0,0,2,323,10
Mexico city,2020-02-23,0,0,0,0,1,324,10
Mexico city,2020-02-24,0,0,0,0,7,331,10
Mexico city,2020-02-25,0,0,0,0,4,335,10
Mexico city,2020-02-26,0,0,0,0,8,343,10
Mexico city,2020-02-27,3,3,0,0,15,358,10
Mexico city,2020-02-28,0,3,0,0,12,370,10
Mexico city,2020-02-29,0,3,0,0,3,373,10
Mexico city,2020-03-01,0,3,0,0,3,376,10
Mexico city,2020-03-02,1,4,0,0,23,399,10
Mexico city,2020-03-03,0,4,0,0,7,406,10
Mexico city,2020-03-04,0,4,0,0,14,420,10
Mexico city,2020-03-05,1,5,0,0,17,437,10
Mexico city,2020-03-06,0,5,0,0,14,451,10
Mexico city,2020-03-07,1,6,0,0,7,458,10
Mexico city,2020-03-08,1,7,0,0,8,466,10
Mexico city,2020-03-09,0,7,0,0,20,486,10
Mexico city,2020-03-10,3,10,0,0,30,516,10
Mexico city,2020-03-11,12,22,0,0,45,561,10
Mexico city,2020-03-12,17,39,0,0,71,632,10
Mexico city,2020-03-13,24,63,0,0,73,705,10
Mexico city,2020-03-14,21,84,0,0,57,762,10
Mexico city,2020-03-15,10,94,0,0,41,803,10
Mexico city,2020-03-16,26,120,0,0,72,875,10
Mexico city,2020-03-17,34,154,0,0,109,984,10
Mexico city,2020-03-18,31,185,0,0,118,1102,10
Mexico city,2020-03-19,39,224,0,0,131,1233,10
Mexico city,2020-03-20,24,248,0,0,101,1334,10
Mexico city,2020-03-21,12,260,0,0,46,1380,10
Mexico city,2020-03-22,11,271,1,1,30,1410,10
Mexico city,2020-03-23,25,296,1,2,91,1501,10
Mexico city,2020-03-24,34,330,0,2,183,1684,10
Mexico city,2020-03-25,25,355,1,3,175,1859,10
Mexico city,2020-03-26,51,406,3,6,180,2039,10
Mexico city,2020-03-27,39,445,3,9,227,2266,10
Mexico city,2020-03-28,48,493,1,10,115,2381,10
Mexico city,2020-03-29,35,528,2,12,103,2484,10
Mexico city,2020-03-30,77,605,4,16,225,2709,10
Mexico city,2020-03-31,51,656,7,23,200,2909,10
Mexico city,2020-04-01,55,711,5,28,199,3108,10
Mexico city,2020-04-02,71,782,5,33,280,3388,10
Mexico city,2020-04-03,79,861,7,40,329,3717,10
Mexico city,2020-04-04,56,917,5,45,158,3875,10
Mexico city,2020-04-05,54,971,4,49,120,3995,10
Mexico city,2020-04-06,117,1088,16,65,349,4344,10
Mexico city,2020-04-07,127,1215,10,75,466,4810,10
Mexico city,2020-04-08,125,1340,6,81,522,5332,10
Mexico city,2020-04-09,127,1467,17,98,421,5753,10
Mexico city,2020-04-10,147,1614,22,120,458,6211,10
Mexico city,2020-04-11,111,1725,22,142,236,6447,10
Mexico city,2020-04-12,115,1840,10,152,220,6667,10
Mexico city,2020-04-13,267,2107,14,166,673,7340,10
Mexico city,2020-04-14,246,2353,23,189,714,8054,10
Mexico city,2020-04-15,225,2578,20,209,635,8689,10
Mexico city,2020-04-16,249,2827,23,232,645,9334,10
Mexico city,2020-04-17,327,3154,16,248,839,10173,10
Mexico city,2020-04-18,197,3351,22,270,329,10502,0
Mexico city,2020-04-19,185,3536,29,299,320,10822,0
Mexico city,2020-04-20,444,3980,24,323,908,11730,0
Mexico city,2020-04-21,431,4411,37,360,913,12643,0
Mexico city,2020-04-22,399,4810,26,386,858,13501,0
Mexico city,2020-04-23,343,5153,29,415,721,14222,0
Mexico city,2020-04-24,508,5661,38,453,979,15201,0
Mexico city,2020-04-25,244,5905,50,503,439,15640,0
Mexico city,2020-04-26,221,6126,47,550,385,16025,0
Mexico city,2020-04-27,491,6617,41,591,1051,17076,0
Mexico city,2020-04-28,533,7150,36,627,1183,18259,0
Mexico city,2020-04-29,561,7711,53,680,1254,19513,0
Mexico city,2020-04-30,530,8241,63,743,1405,20918,0
Mexico city,2020-05-01,325,8566,56,799,627,21545,0
Mexico city,2020-05-02,318,8884,46,845,611,22156,0
Mexico city,2020-05-03,290,9174,61,906,610,22766,0
Mexico city,2020-05-04,710,9884,53,959,1578,24344,0
Mexico city,2020-05-05,578,10462,67,1026,1265,25609,0
Mexico city,2020-05-06,678,11140,71,1097,1609,27218,0
Mexico city,2020-05-07,692,11832,60,1157,1477,28695,0
Mexico city,2020-05-08,777,12609,68,1225,1743,30438,0
Mexico city,2020-05-09,388,12997,63,1288,765,31203,0
Mexico city,2020-05-10,348,13345,71,1359,600,31803,0
Mexico city,2020-05-11,768,14113,68,1427,1590,33393,0
Mexico city,2020-05-12,788,14901,76,1503,1688,35081,0
Mexico city,2020-05-13,868,15769,80,1583,1764,36845,0
Mexico city,2020-05-14,771,16540,83,1666,1729,38574,0
Mexico city,2020-05-15,895,17435,88,1754,1842,40416,0
Mexico city,2020-05-16,554,17989,80,1834,959,41375,0
Mexico city,2020-05-17,353,18342,89,1923,617,41992,0
Mexico city,2020-05-18,1002,19344,98,2021,2058,44050,0
Mexico city,2020-05-19,944,20288,87,2108,1999,46049,0
Mexico city,2020-05-20,949,21237,68,2176,2062,48111,0
Mexico city,2020-05-21,917,22154,96,2272,1894,50005,0
Mexico city,2020-05-22,817,22971,85,2357,1939,51944,0
Mexico city,2020-05-23,397,23368,88,2445,871,52815,0
Mexico city,2020-05-24,309,23677,83,2528,658,53473,0
Mexico city,2020-05-25,963,24640,88,2616,2115,55588,0
Mexico city,2020-05-26,858,25498,79,2695,1934,57522,0
Mexico city,2020-05-27,929,26427,76,2771,2113,59635,0
Mexico city,2020-05-28,805,27232,81,2852,1721,61356,0
Mexico city,2020-05-29,860,28092,67,2919,1895,63251,0
Mexico city,2020-05-30,495,28587,64,2983,1053,64304,0
Mexico city,2020-05-31,380,28967,89,3072,690,64994,0
Mexico city,2020-06-01,984,29951,84,3156,2160,67154,0
Mexico city,2020-06-02,856,30807,55,3211,1960,69114,0
Mexico city,2020-06-03,914,31721,80,3291,2181,71295,0
Mexico city,2020-06-04,859,32580,79,3370,2079,73374,0
Mexico city,2020-06-05,873,33453,77,3447,2141,75515,0
Mexico city,2020-06-06,441,33894,84,3531,958,76473,0
Mexico city,2020-06-07,332,34226,70,3601,606,77079,0
Mexico city,2020-06-08,907,35133,70,3671,2172,79251,0
Mexico city,2020-06-09,883,36016,72,3743,2101,81352,0
Mexico city,2020-06-10,801,36817,74,3817,2063,83415,0
Mexico city,2020-06-11,742,37559,60,3877,2079,85494,0
Mexico city,2020-06-12,687,38246,79,3956,2176,87670,0
Mexico city,2020-06-13,202,38448,69,4025,865,88535,0
Mexico city,2020-06-14,130,38578,54,4079,647,89182,0
Mexico city,2020-06-15,203,38781,27,4106,2216,91398,0
Mexico city,2020-06-16,89,38870,23,4129,2099,93497,0
Mexico city,2020-06-17,1,38871,3,4132,1311,94808,0
Monterrey,2019-12-31,0,0,0,0,0,0,1
Monterrey,2020-01-01,0,0,0,0,0,0,1
Monterrey,2020-01-02,0,0,0,0,0,0,1
Monterrey,2020-01-03,0,0,0,0,0,0,1
Monterrey,2020-01-04,0,0,0,0,0,0,1
Monterrey,2020-01-05,0,0,0,0,0,0,1
Monterrey,2020-01-06,0,0,0,0,0,0,1
Monterrey,2020-01-07,0,0,0,0,0,0,1
Monterrey,2020-01-08,0,0,0,0,0,0,1
Monterrey,2020-01-09,0,0,0,0,0,0,1
Monterrey,2020-01-10,0,0,0,0,0,0,1
Monterrey,2020-01-11,0,0,0,0,0,0,1
Monterrey,2020-01-12,0,0,0,0,0,0,1
Monterrey,2020-01-13,0,0,0,0,0,0,1
Monterrey,2020-01-14,0,0,0,0,0,0,1
Monterrey,2020-01-15,0,0,0,0,0,0,1
Monterrey,2020-01-16,0,0,0,0,0,0,1
Monterrey,2020-01-17,0,0,0,0,0,0,1
Monterrey,2020-01-18,0,0,0,0,0,0,1
Monterrey,2020-01-19,0,0,0,0,0,0,1
Monterrey,2020-01-20,0,0,0,0,0,0,1
Monterrey,2020-01-21,0,0,0,0,2,2,1
Monterrey,2020-01-22,0,0,0,0,1,3,1
Monterrey,2020-01-23,0,0,0,0,0,3,1
Monterrey,2020-01-24,0,0,0,0,0,3,1
Monterrey,2020-01-25,0,0,0,0,0,3,1
Monterrey,2020-01-26,0,0,0,0,0,3,1
Monterrey,2020-01-27,0,0,0,0,0,3,1
Monterrey,2020-01-28,0,0,0,0,0,3,1
Monterrey,2020-01-29,0,0,0,0,0,3,1
Monterrey,2020-01-30,0,0,0,0,0,3,1
Monterrey,2020-01-31,0,0,0,0,0,3,1
Monterrey,2020-02-01,0,0,0,0,0,3,1
Monterrey,2020-02-02,0,0,0,0,0,3,1
Monterrey,2020-02-03,0,0,0,0,0,3,1
Monterrey,2020-02-04,0,0,0,0,0,3,1
Monterrey,2020-02-05,0,0,0,0,0,3,1
Monterrey,2020-02-06,0,0,0,0,1,4,1
Monterrey,2020-02-07,0,0,0,0,0,4,1
Monterrey,2020-02-08,0,0,0,0,0,4,1
Monterrey,2020-02-09,0,0,0,0,0,4,1
Monterrey,2020-02-10,0,0,0,0,1,5,1
Monterrey,2020-02-11,0,0,0,0,0,5,1
Monterrey,2020-02-12,0,0,0,0,0,5,1
Monterrey,2020-02-13,0,0,0,0,0,5,1
Monterrey,2020-02-14,0,0,0,0,0,5,1
Monterrey,2020-02-15,0,0,0,0,0,5,1
Monterrey,2020-02-16,0,0,0,0,0,5,1
Monterrey,2020-02-17,0,0,0,0,0,5,1
Monterrey,2020-02-18,0,0,0,0,0,5,1
Monterrey,2020-02-19,0,0,0,0,0,5,1
Monterrey,2020-02-20,0,0,0,0,0,5,1
Monterrey,2020-02-21,0,0,0,0,0,5,1
Monterrey,2020-02-22,0,0,0,0,0,5,1
Monterrey,2020-02-23,0,0,0,0,0,5,1
Monterrey,2020-02-24,0,0,0,0,0,5,1
Monterrey,2020-02-25,0,0,0,0,1,6,1
Monterrey,2020-02-26,0,0,0,0,0,6,1
Monterrey,2020-02-27,0,0,0,0,1,7,1
Monterrey,2020-02-28,0,0,0,0,2,9,1
Monterrey,2020-02-29,0,0,0,0,0,9,1
Monterrey,2020-03-01,0,0,0,0,1,10,1
Monterrey,2020-03-02,0,0,0,0,2,12,1
Monterrey,2020-03-03,0,0,0,0,3,15,1
Monterrey,2020-03-04,0,0,0,0,0,15,1
Monterrey,2020-03-05,0,0,0,0,0,15,1
Monterrey,2020-03-06,0,0,0,0,1,16,1
Monterrey,2020-03-07,0,0,0,0,1,17,1
Monterrey,2020-03-08,0,0,0,0,0,17,1
Monterrey,2020-03-09,0,0,0,0,4,21,1
Monterrey,2020-03-10,0,0,0,0,1,22,1
Monterrey,2020-03-11,1,1,0,0,4,26,1
Monterrey,2020-03-12,0,1,0,0,6,32,1
Monterrey,2020-03-13,2,3,0,0,20,52,1
Monterrey,2020-03-14,2,5,0,0,9,61,1
Monterrey,2020-03-15,0,5,0,0,2,63,1
Monterrey,2020-03-16,2,7,0,0,11,74,1
Monterrey,2020-03-17,0,7,0,0,15,89,1
Monterrey,2020-03-18,1,8,0,0,10,99,1
Monterrey,2020-03-19,2,10,0,0,26,125,1
Monterrey,2020-03-20,3,13,0,0,19,144,1
Monterrey,2020-03-21,4,17,0,0,22,166,1
Monterrey,2020-03-22,2,19,0,0,13,179,1
Monterrey,2020-03-23,1,20,0,0,22,201,1
Monterrey,2020-03-24,1,21,0,0,30,231,1
Monterrey,2020-03-25,0,21,0,0,36,267,1
Monterrey,2020-03-26,0,21,0,0,21,288,1
Monterrey,2020-03-27,4,25,0,0,28,316,1
Monterrey,2020-03-28,1,26,0,0,23,339,1
Monterrey,2020-03-29,1,27,0,0,17,356,1
Monterrey,2020-03-30,4,31,0,0,33,389,1
Monterrey,2020-03-31,0,31,0,0,26,415,1
Monterrey,2020-04-01,0,31,0,0,31,446,1
Monterrey,2020-04-02,1,32,0,0,21,467,1
Monterrey,2020-04-03,1,33,0,0,29,496,1
Monterrey,2020-04-04,0,33,0,0,19,515,1
Monterrey,2020-04-05,0,33,1,1,13,528,1
Monterrey,2020-04-06,3,36,0,1,29,557,1
Monterrey,2020-04-07,2,38,1,2,32,589,1
Monterrey,2020-04-08,4,42,0,2,32,621,1
Monterrey,2020-04-09,0,42,0,2,80,701,1
Monterrey,2020-04-10,5,47,0,2,148,849,1
Monterrey,2020-04-11,3,50,0,2,109,958,1
Monterrey,2020-04-12,3,53,0,2,77,1035,1
Monterrey,2020-04-13,9,62,1,3,86,1121,1
Monterrey,2020-04-14,6,68,0,3,95,1216,1
Monterrey,2020-04-15,2,70,0,3,86,1302,1
Monterrey,2020-04-16,4,74,0,3,93,1395,1
Monterrey,2020-04-17,3,77,0,3,55,1450,1
Monterrey,2020-04-18,1,78,0,3,16,1466,0
Monterrey,2020-04-19,1,79,0,3,29,1495,0
Monterrey,2020-04-20,2,81,0,3,41,1536,0
Monterrey,2020-04-21,4,85,0,3,20,1556,0
Monterrey,2020-04-22,3,88,1,4,20,1576,0
Monterrey,2020-04-23,2,90,1,5,24,1600,0
Monterrey,2020-04-24,3,93,1,6,23,1623,0
Monterrey,2020-04-25,1,94,0,6,20,1643,0
Monterrey,2020-04-26,2,96,0,6,28,1671,0
Monterrey,2020-04-27,3,99,0,6,36,1707,0
Monterrey,2020-04-28,4,103,2,8,53,1760,0
Monterrey,2020-04-29,6,109,0,8,42,1802,0
Monterrey,2020-04-30,2,111,1,9,33,1835,0
Monterrey,2020-05-01,2,113,0,9,28,1863,0
Monterrey,2020-05-02,6,119,1,10,24,1887,0
Monterrey,2020-05-03,2,121,1,11,19,1906,0
Monterrey,2020-05-04,7,128,1,12,53,1959,0
Monterrey,2020-05-05,2,130,1,13,57,2016,0
Monterrey,2020-05-06,6,136,1,14,35,2051,0
Monterrey,2020-05-07,3,139,0,14,35,2086,0
Monterrey,2020-05-08,5,144,0,14,43,2129,0
Monterrey,2020-05-09,10,154,0,14,59,2188,0
Monterrey,2020-05-10,3,157,0,14,26,2214,0
Monterrey,2020-05-11,6,163,0,14,61,2275,0
Monterrey,2020-05-12,8,171,0,14,77,2352,0
Monterrey,2020-05-13,11,182,1,15,77,2429,0
Monterrey,2020-05-14,9,191,0,15,75,2504,0
Monterrey,2020-05-15,21,212,1,16,63,2567,0
Monterrey,2020-05-16,12,224,1,17,74,2641,0
Monterrey,2020-05-17,3,227,1,18,34,2675,0
Monterrey,2020-05-18,12,239,1,19,94,2769,0
Monterrey,2020-05-19,10,249,0,19,75,2844,0
Monterrey,2020-05-20,14,263,4,23,80,2924,0
Monterrey,2020-05-21,13,276,0,23,77,3001,0
Monterrey,2020-05-22,13,289,0,23,93,3094,0
Monterrey,2020-05-23,6,295,0,23,83,3177,0
Monterrey,2020-05-24,10,305,0,23,67,3244,0
Monterrey,2020-05-25,32,337,3,26,119,3363,0
Monterrey,2020-05-26,41,378,3,29,156,3519,0
Monterrey,2020-05-27,16,394,0,29,111,3630,0
Monterrey,2020-05-28,14,408,2,31,126,3756,0
Monterrey,2020-05-29,24,432,0,31,167,3923,0
Monterrey,2020-05-30,12,444,1,32,75,3998,0
Monterrey,2020-05-31,4,448,2,34,27,4025,0
Monterrey,2020-06-01,29,477,0,34,107,4132,0
Monterrey,2020-06-02,25,502,1,35,116,4248,0
Monterrey,2020-06-03,22,524,0,35,99,4347,0
Monterrey,2020-06-04,45,569,1,36,153,4500,0
Monterrey,2020-06-05,37,606,0,36,142,4642,0
Monterrey,2020-06-06,15,621,3,39,97,4739,0
Monterrey,2020-06-07,6,627,1,40,55,4794,0
Monterrey,2020-06-08,94,721,0,40,226,5020,0
Monterrey,2020-06-09,40,761,2,42,161,5181,0
Monterrey,2020-06-10,53,814,2,44,215,5396,0
Monterrey,2020-06-11,63,877,1,45,183,5579,0
Monterrey,2020-06-12,54,931,0,45,239,5818,0
Monterrey,2020-06-13,14,945,2,47,150,5968,0
Monterrey,2020-06-14,8,953,0,47,81,6049,0
Monterrey,2020-06-15,15,968,3,50,200,6249,0
Monterrey,2020-06-16,2,970,1,51,146,6395,0
Monterrey,2020-06-17,0,970,1,52,45,6440,0
Acapulco de Juarez,2019-12-31,0,0,0,0,0,0,1
Acapulco de Juarez,2020-01-01,0,0,0,0,0,0,1
Acapulco de Juarez,2020-01-02,0,0,0,0,0,0,1
Acapulco de Juarez,2020-01-03,0,0,0,0,0,0,1
Acapulco de Juarez,2020-01-04,0,0,0,0,0,0,1
Acapulco de Juarez,2020-01-05,0,0,0,0,0,0,1
Acapulco de Juarez,2020-01-06,0,0,0,0,0,0,1
Acapulco de Juarez,2020-01-07,0,0,0,0,0,0,1
Acapulco de Juarez,2020-01-08,0,0,0,0,0,0,1
Acapulco de Juarez,2020-01-09,0,0,0,0,0,0,1
Acapulco de Juarez,2020-01-10,0,0,0,0,1,1,1
Acapulco de Juarez,2020-01-11,0,0,0,0,0,1,1
Acapulco de Juarez,2020-01-12,0,0,0,0,0,1,1
Acapulco de Juarez,2020-01-13,0,0,0,0,0,1,1
Acapulco de Juarez,2020-01-14,0,0,0,0,0,1,1
Acapulco de Juarez,2020-01-15,0,0,0,0,0,1,1
Acapulco de Juarez,2020-01-16,0,0,0,0,0,1,1
Acapulco de Juarez,2020-01-17,0,0,0,0,0,1,1
Acapulco de Juarez,2020-01-18,0,0,0,0,0,1,1
Acapulco de Juarez,2020-01-19,0,0,0,0,0,1,1
Acapulco de Juarez,2020-01-20,0,0,0,0,1,2,1
Acapulco de Juarez,2020-01-21,0,0,0,0,0,2,1
Acapulco de Juarez,2020-01-22,0,0,0,0,0,2,1
Acapulco de Juarez,2020-01-23,0,0,0,0,0,2,1
Acapulco de Juarez,2020-01-24,0,0,0,0,0,2,1
Acapulco de Juarez,2020-01-25,0,0,0,0,0,2,1
Acapulco de Juarez,2020-01-26,0,0,0,0,0,2,1
Acapulco de Juarez,2020-01-27,0,0,0,0,0,2,1
Acapulco de Juarez,2020-01-28,0,0,0,0,0,2,1
Acapulco de Juarez,2020-01-29,0,0,0,0,0,2,1
Acapulco de Juarez,2020-01-30,0,0,0,0,0,2,1
Acapulco de Juarez,2020-01-31,0,0,0,0,0,2,1
Acapulco de Juarez,2020-02-01,0,0,0,0,0,2,1
Acapulco de Juarez,2020-02-02,0,0,0,0,0,2,1
Acapulco de Juarez,2020-02-03,0,0,0,0,0,2,1
Acapulco de Juarez,2020-02-04,0,0,0,0,0,2,1
Acapulco de Juarez,2020-02-05,0,0,0,0,0,2,1
Acapulco de Juarez,2020-02-06,0,0,0,0,0,2,1
Acapulco de Juarez,2020-02-07,0,0,0,0,0,2,1
Acapulco de Juarez,2020-02-08,0,0,0,0,0,2,1
Acapulco de Juarez,2020-02-09,0,0,0,0,0,2,1
Acapulco de Juarez,2020-02-10,0,0,0,0,0,2,1
Acapulco de Juarez,2020-02-11,0,0,0,0,0,2,1
Acapulco de Juarez,2020-02-12,0,0,0,0,0,2,1
Acapulco de Juarez,2020-02-13,0,0,0,0,0,2,1
Acapulco de Juarez,2020-02-14,0,0,0,0,0,2,1
Acapulco de Juarez,2020-02-15,0,0,0,0,0,2,1
Acapulco de Juarez,2020-02-16,0,0,0,0,0,2,1
Acapulco de Juarez,2020-02-17,0,0,0,0,0,2,1
Acapulco de Juarez,2020-02-18,0,0,0,0,0,2,1
Acapulco de Juarez,2020-02-19,0,0,0,0,0,2,1
Acapulco de Juarez,2020-02-20,0,0,0,0,0,2,1
Acapulco de Juarez,2020-02-21,0,0,0,0,1,3,1
Acapulco de Juarez,2020-02-22,0,0,0,0,0,3,1
Acapulco de Juarez,2020-02-23,0,0,0,0,0,3,1
Acapulco de Juarez,2020-02-24,0,0,0,0,0,3,1
Acapulco de Juarez,2020-02-25,0,0,0,0,0,3,1
Acapulco de Juarez,2020-02-26,0,0,0,0,0,3,1
Acapulco de Juarez,2020-02-27,0,0,0,0,0,3,1
Acapulco de Juarez,2020-02-28,0,0,0,0,0,3,1
Acapulco de Juarez,2020-02-29,0,0,0,0,0,3,1
Acapulco de Juarez,2020-03-01,0,0,0,0,0,3,1
Acapulco de Juarez,2020-03-02,0,0,0,0,0,3,1
Acapulco de Juarez,2020-03-03,0,0,0,0,0,3,1
Acapulco de Juarez,2020-03-04,0,0,0,0,0,3,1
Acapulco de Juarez,2020-03-05,0,0,0,0,0,3,1
Acapulco de Juarez,2020-03-06,0,0,0,0,0,3,1
Acapulco de Juarez,2020-03-07,0,0,0,0,0,3,1
Acapulco de Juarez,2020-03-08,0,0,0,0,1,4,1
Acapulco de Juarez,2020-03-09,0,0,0,0,2,6,1
Acapulco de Juarez,2020-03-10,0,0,0,0,0,6,1
Acapulco de Juarez,2020-03-11,0,0,0,0,0,6,1
Acapulco de Juarez,2020-03-12,0,0,0,0,0,6,1
Acapulco de Juarez,2020-03-13,1,1,0,0,6,12,1
Acapulco de Juarez,2020-03-14,0,1,0,0,0,12,1
Acapulco de Juarez,2020-03-15,0,1,0,0,0,12,1
Acapulco de Juarez,2020-03-16,2,3,0,0,3,15,1
Acapulco de Juarez,2020-03-17,3,6,0,0,5,20,1
Acapulco de Juarez,2020-03-18,0,6,0,0,1,21,1
Acapulco de Juarez,2020-03-19,0,6,0,0,0,21,1
Acapulco de Juarez,2020-03-20,0,6,0,0,2,23,1
Acapulco de Juarez,2020-03-21,1,7,0,0,1,24,1
Acapulco de Juarez,2020-03-22,0,7,0,0,0,24,1
Acapulco de Juarez,2020-03-23,1,8,0,0,10,34,1
Acapulco de Juarez,2020-03-24,0,8,0,0,2,36,1
Acapulco de Juarez,2020-03-25,3,11,0,0,14,50,1
Acapulco de Juarez,2020-03-26,4,15,0,0,15,65,1
Acapulco de Juarez,2020-03-27,0,15,0,0,8,73,1
Acapulco de Juarez,2020-03-28,1,16,1,1,8,81,1
Acapulco de Juarez,2020-03-29,1,17,0,1,9,90,1
Acapulco de Juarez,2020-03-30,1,18,0,1,17,107,1
Acapulco de Juarez,2020-03-31,3,21,0,1,12,119,1
Acapulco de Juarez,2020-04-01,2,23,0,1,14,133,1
Acapulco de Juarez,2020-04-02,1,24,0,1,12,145,1
Acapulco de Juarez,2020-04-03,1,25,0,1,4,149,1
Acapulco de Juarez,2020-04-04,0,25,0,1,4,153,1
Acapulco de Juarez,2020-04-05,1,26,0,1,3,156,1
Acapulco de Juarez,2020-04-06,6,32,0,1,14,170,1
Acapulco de Juarez,2020-04-07,6,38,0,1,16,186,1
Acapulco de Juarez,2020-04-08,4,42,0,1,11,197,1
Acapulco de Juarez,2020-04-09,1,43,1,2,5,202,1
Acapulco de Juarez,2020-04-10,1,44,0,2,10,212,1
Acapulco de Juarez,2020-04-11,3,47,0,2,7,219,1
Acapulco de Juarez,2020-04-12,3,50,0,2,8,227,1
Acapulco de Juarez,2020-04-13,8,58,0,2,24,251,1
Acapulco de Juarez,2020-04-14,3,61,1,3,17,268,1
Acapulco de Juarez,2020-04-15,3,64,0,3,16,284,1
Acapulco de Juarez,2020-04-16,3,67,0,3,14,298,1
Acapulco de Juarez,2020-04-17,8,75,0,3,14,312,1
Acapulco de Juarez,2020-04-18,1,76,1,4,8,320,0
Acapulco de Juarez,2020-04-19,1,77,1,5,4,324,0
Acapulco de Juarez,2020-04-20,5,82,0,5,19,343,0
Acapulco de Juarez,2020-04-21,3,85,1,6,14,357,0
Acapulco de Juarez,2020-04-22,3,88,1,7,6,363,0
Acapulco de Juarez,2020-04-23,14,102,0,7,24,387,0
Acapulco de Juarez,2020-04-24,15,117,0,7,26,413,0
Acapulco de Juarez,2020-04-25,3,120,1,8,10,423,0
Acapulco de Juarez,2020-04-26,11,131,1,9,16,439,0
Acapulco de Juarez,2020-04-27,12,143,3,12,25,464,0
Acapulco de Juarez,2020-04-28,18,161,1,13,46,510,0
Acapulco de Juarez,2020-04-29,13,174,1,14,22,532,0
Acapulco de Juarez,2020-04-30,8,182,2,16,23,555,0
Acapulco de Juarez,2020-05-01,10,192,0,16,19,574,0
Acapulco de Juarez,2020-05-02,30,222,3,19,54,628,0
Acapulco de Juarez,2020-05-03,12,234,1,20,20,648,0
Acapulco de Juarez,2020-05-04,27,261,1,21,50,698,0
Acapulco de Juarez,2020-05-05,11,272,1,22,31,729,0
Acapulco de Juarez,2020-05-06,25,297,3,25,54,783,0
Acapulco de Juarez,2020-05-07,15,312,2,27,41,824,0
Acapulco de Juarez,2020-05-08,29,341,2,29,61,885,0
Acapulco de Juarez,2020-05-09,14,355,1,30,31,916,0
Acapulco de Juarez,2020-05-10,20,375,1,31,28,944,0
Acapulco de Juarez,2020-05-11,26,401,1,32,66,1010,0
Acapulco de Juarez,2020-05-12,35,436,2,34,66,1076,0
Acapulco de Juarez,2020-05-13,24,460,5,39,59,1135,0
Acapulco de Juarez,2020-05-14,50,510,5,44,78,1213,0
Acapulco de Juarez,2020-05-15,42,552,9,53,79,1292,0
Acapulco de Juarez,2020-05-16,32,584,4,57,52,1344,0
Acapulco de Juarez,2020-05-17,23,607,6,63,41,1385,0
Acapulco de Juarez,2020-05-18,89,696,9,72,128,1513,0
Acapulco de Juarez,2020-05-19,68,764,5,77,85,1598,0
Acapulco de Juarez,2020-05-20,109,873,14,91,129,1727,0
Acapulco de Juarez,2020-05-21,93,966,7,98,126,1853,0
Acapulco de Juarez,2020-05-22,71,1037,7,105,104,1957,0
Acapulco de Juarez,2020-05-23,50,1087,15,120,72,2029,0
Acapulco de Juarez,2020-05-24,34,1121,13,133,48,2077,0
Acapulco de Juarez,2020-05-25,85,1206,15,148,104,2181,0
Acapulco de Juarez,2020-05-26,78,1284,8,156,108,2289,0
Acapulco de Juarez,2020-05-27,73,1357,13,169,125,2414,0
Acapulco de Juarez,2020-05-28,71,1428,14,183,103,2517,0
Acapulco de Juarez,2020-05-29,61,1489,14,197,109,2626,0
Acapulco de Juarez,2020-05-30,37,1526,9,206,77,2703,0
Acapulco de Juarez,2020-05-31,58,1584,19,225,80,2783,0
Acapulco de Juarez,2020-06-01,88,1672,14,239,125,2908,0
Acapulco de Juarez,2020-06-02,60,1732,16,255,117,3025,0
Acapulco de Juarez,2020-06-03,75,1807,4,259,108,3133,0
Acapulco de Juarez,2020-06-04,69,1876,6,265,102,3235,0
Acapulco de Juarez,2020-06-05,72,1948,15,280,111,3346,0
Acapulco de Juarez,2020-06-06,57,2005,4,284,94,3440,0
Acapulco de Juarez,2020-06-07,39,2044,13,297,50,3490,0
Acapulco de Juarez,2020-06-08,72,2116,10,307,119,3609,0
Acapulco de Juarez,2020-06-09,63,2179,7,314,98,3707,0
Acapulco de Juarez,2020-06-10,71,2250,13,327,110,3817,0
Acapulco de Juarez,2020-06-11,65,2315,9,336,104,3921,0
Acapulco de Juarez,2020-06-12,44,2359,3,339,117,4038,0
Acapulco de Juarez,2020-06-13,14,2373,10,349,75,4113,0
Acapulco de Juarez,2020-06-14,13,2386,9,358,54,4167,0
Acapulco de Juarez,2020-06-15,0,2386,1,359,65,4232,0
Acapulco de Juarez,2020-06-16,0,2386,2,361,97,4329,0
Acapulco de Juarez,2020-06-17,0,2386,0,361,10,4339,0
Zapopan,2019-12-31,0,0,0,0,0,0,1
Zapopan,2020-01-01,0,0,0,0,1,1,1
Zapopan,2020-01-02,0,0,0,0,0,1,1
Zapopan,2020-01-03,0,0,0,0,1,2,1
Zapopan,2020-01-04,0,0,0,0,0,2,1
Zapopan,2020-01-05,0,0,0,0,1,3,1
Zapopan,2020-01-06,0,0,0,0,0,3,1
Zapopan,2020-01-07,0,0,0,0,0,3,1
Zapopan,2020-01-08,0,0,0,0,1,4,1
Zapopan,2020-01-09,0,0,0,0,1,5,1
Zapopan,2020-01-10,0,0,0,0,1,6,1
Zapopan,2020-01-11,0,0,0,0,3,9,1
Zapopan,2020-01-12,0,0,0,0,1,10,1
Zapopan,2020-01-13,0,0,0,0,2,12,1
Zapopan,2020-01-14,0,0,0,0,4,16,1
Zapopan,2020-01-15,0,0,0,0,6,22,1
Zapopan,2020-01-16,0,0,0,0,4,26,1
Zapopan,2020-01-17,0,0,0,0,5,31,1
Zapopan,2020-01-18,0,0,0,0,2,33,1
Zapopan,2020-01-19,0,0,0,0,1,34,1
Zapopan,2020-01-20,0,0,0,0,4,38,1
Zapopan,2020-01-21,0,0,0,0,7,45,1
Zapopan,2020-01-22,0,0,0,0,4,49,1
Zapopan,2020-01-23,0,0,0,0,2,51,1
Zapopan,2020-01-24,0,0,0,0,4,55,1
Zapopan,2020-01-25,0,0,0,0,1,56,1
Zapopan,2020-01-26,0,0,0,0,0,56,1
Zapopan,2020-01-27,0,0,0,0,3,59,1
Zapopan,2020-01-28,0,0,0,0,5,64,1
Zapopan,2020-01-29,0,0,0,0,1,65,1
Zapopan,2020-01-30,0,0,0,0,3,68,1
Zapopan,2020-01-31,0,0,0,0,3,71,1
Zapopan,2020-02-01,0,0,0,0,2,73,1
Zapopan,2020-02-02,0,0,0,0,3,76,1
Zapopan,2020-02-03,0,0,0,0,2,78,1
Zapopan,2020-02-04,0,0,0,0,1,79,1
Zapopan,2020-02-05,0,0,0,0,1,80,1
Zapopan,2020-02-06,0,0,0,0,2,82,1
Zapopan,2020-02-07,0,0,0,0,2,84,1
Zapopan,2020-02-08,0,0,0,0,1,85,1
Zapopan,2020-02-09,0,0,0,0,2,87,1
Zapopan,2020-02-10,0,0,0,0,4,91,1
Zapopan,2020-02-11,0,0,0,0,1,92,1
Zapopan,2020-02-12,0,0,0,0,3,95,1
Zapopan,2020-02-13,0,0,0,0,1,96,1
Zapopan,2020-02-14,0,0,0,0,3,99,1
Zapopan,2020-02-15,0,0,0,0,0,99,1
Zapopan,2020-02-16,0,0,0,0,4,103,1
Zapopan,2020-02-17,0,0,0,0,3,106,1
Zapopan,2020-02-18,0,0,0,0,1,107,1
Zapopan,2020-02-19,0,0,0,0,0,107,1
Zapopan,2020-02-20,0,0,0,0,2,109,1
Zapopan,2020-02-21,0,0,0,0,0,109,1
Zapopan,2020-02-22,0,0,0,0,1,110,1
Zapopan,2020-02-23,0,0,0,0,1,111,1
Zapopan,2020-02-24,0,0,0,0,3,114,1
Zapopan,2020-02-25,0,0,0,0,1,115,1
Zapopan,2020-02-26,0,0,0,0,3,118,1
Zapopan,2020-02-27,0,0,0,0,1,119,1
Zapopan,2020-02-28,0,0,0,0,1,120,1
Zapopan,2020-02-29,0,0,0,0,0,120,1
Zapopan,2020-03-01,0,0,0,0,1,121,1
Zapopan,2020-03-02,0,0,0,0,1,122,1
Zapopan,2020-03-03,0,0,0,0,3,125,1
Zapopan,2020-03-04,0,0,0,0,5,130,1
Zapopan,2020-03-05,0,0,0,0,1,131,1
Zapopan,2020-03-06,0,0,0,0,3,134,1
Zapopan,2020-03-07,0,0,0,0,1,135,1
Zapopan,2020-03-08,0,0,0,0,1,136,1
Zapopan,2020-03-09,0,0,0,0,0,136,1
Zapopan,2020-03-10,0,0,0,0,5,141,1
Zapopan,2020-03-11,0,0,0,0,2,143,1
Zapopan,2020-03-12,2,2,0,0,10,153,1
Zapopan,2020-03-13,2,4,0,0,9,162,1
Zapopan,2020-03-14,3,7,0,0,4,166,1
Zapopan,2020-03-15,0,7,0,0,6,172,1
Zapopan,2020-03-16,6,13,0,0,10,182,1
Zapopan,2020-03-17,2,15,0,0,15,197,1
Zapopan,2020-03-18,14,29,0,0,29,226,1
Zapopan,2020-03-19,4,33,0,0,21,247,1
Zapopan,2020-03-20,1,34,0,0,14,261,1
Zapopan,2020-03-21,1,35,0,0,16,277,1
Zapopan,2020-03-22,0,35,0,0,14,291,1
Zapopan,2020-03-23,3,38,0,0,21,312,1
Zapopan,2020-03-24,7,45,0,0,41,353,1
Zapopan,2020-03-25,1,46,0,0,21,374,1
Zapopan,2020-03-26,0,46,1,1,18,392,1
Zapopan,2020-03-27,1,47,0,1,23,415,1
Zapopan,2020-03-28,0,47,0,1,18,433,1
Zapopan,2020-03-29,1,48,0,1,15,448,1
Zapopan,2020-03-30,3,51,0,1,24,472,1
Zapopan,2020-03-31,0,51,0,1,26,498,1
Zapopan,2020-04-01,0,51,0,1,32,530,1
Zapopan,2020-04-02,2,53,0,1,31,561,1
Zapopan,2020-04-03,0,53,0,1,27,588,1
Zapopan,2020-04-04,0,53,0,1,24,612,1
Zapopan,2020-04-05,0,53,0,1,9,621,1
Zapopan,2020-04-06,1,54,0,1,35,656,1
Zapopan,2020-04-07,1,55,0,1,32,688,1
Zapopan,2020-04-08,0,55,0,1,16,704,1
Zapopan,2020-04-09,0,55,0,1,22,726,1
Zapopan,2020-04-10,0,55,0,1,12,738,1
Zapopan,2020-04-11,0,55,0,1,14,752,1
Zapopan,2020-04-12,0,55,0,1,8,760,1
Zapopan,2020-04-13,1,56,0,1,17,777,1
Zapopan,2020-04-14,1,57,0,1,16,793,1
Zapopan,2020-04-15,2,59,0,1,9,802,1
Zapopan,2020-04-16,1,60,0,1,18,820,1
Zapopan,2020-04-17,1,61,0,1,38,858,1
Zapopan,2020-04-18,0,61,0,1,12,870,0
Zapopan,2020-04-19,0,61,0,1,2,872,0
Zapopan,2020-04-20,1,62,0,1,28,900,0
Zapopan,2020-04-21,0,62,0,1,20,920,0
Zapopan,2020-04-22,2,64,0,1,37,957,0
Zapopan,2020-04-23,1,65,0,1,31,988,0
Zapopan,2020-04-24,1,66,0,1,60,1048,0
Zapopan,2020-04-25,1,67,0,1,16,1064,0
Zapopan,2020-04-26,1,68,0,1,10,1074,0
Zapopan,2020-04-27,1,69,0,1,20,1094,0
Zapopan,2020-04-28,0,69,1,2,23,1117,0
Zapopan,2020-04-29,5,74,0,2,27,1144,0
Zapopan,2020-04-30,2,76,1,3,31,1175,0
Zapopan,2020-05-01,3,79,0,3,20,1195,0
Zapopan,2020-05-02,4,83,0,3,10,1205,0
Zapopan,2020-05-03,2,85,0,3,5,1210,0
Zapopan,2020-05-04,3,88,0,3,36,1246,0
Zapopan,2020-05-05,3,91,0,3,26,1272,0
Zapopan,2020-05-06,1,92,0,3,17,1289,0
Zapopan,2020-05-07,8,100,0,3,48,1337,0
Zapopan,2020-05-08,4,104,0,3,26,1363,0
Zapopan,2020-05-09,2,106,0,3,48,1411,0
Zapopan,2020-05-10,1,107,0,3,17,1428,0
Zapopan,2020-05-11,3,110,0,3,32,1460,0
Zapopan,2020-05-12,4,114,0,3,28,1488,0
Zapopan,2020-05-13,3,117,0,3,24,1512,0
Zapopan,2020-05-14,6,123,0,3,54,1566,0
Zapopan,2020-05-15,3,126,1,4,28,1594,0
Zapopan,2020-05-16,3,129,0,4,30,1624,0
Zapopan,2020-05-17,1,130,0,4,11,1635,0
Zapopan,2020-05-18,7,137,0,4,31,1666,0
Zapopan,2020-05-19,6,143,0,4,27,1693,0
Zapopan,2020-05-20,3,146,1,5,23,1716,0
Zapopan,2020-05-21,3,149,2,7,42,1758,0
Zapopan,2020-05-22,14,163,1,8,55,1813,0
Zapopan,2020-05-23,10,173,1,9,50,1863,0
Zapopan,2020-05-24,4,177,0,9,19,1882,0
Zapopan,2020-05-25,17,194,2,11,47,1929,0
Zapopan,2020-05-26,28,222,1,12,70,1999,0
Zapopan,2020-05-27,17,239,0,12,83,2082,0
Zapopan,2020-05-28,15,254,0,12,57,2139,0
Zapopan,2020-05-29,22,276,1,13,74,2213,0
Zapopan,2020-05-30,32,308,0,13,70,2283,0
Zapopan,2020-05-31,6,314,0,13,17,2300,0
Zapopan,2020-06-01,40,354,4,17,100,2400,0
Zapopan,2020-06-02,28,382,0,17,83,2483,0
Zapopan,2020-06-03,42,424,0,17,100,2583,0
Zapopan,2020-06-04,38,462,1,18,86,2669,0
Zapopan,2020-06-05,40,502,1,19,103,2772,0
Zapopan,2020-06-06,16,518,0,19,44,2816,0
Zapopan,2020-06-07,12,530,2,21,26,2842,0
Zapopan,2020-06-08,40,570,0,21,106,2948,0
Zapopan,2020-06-09,39,609,4,25,101,3049,0
Zapopan,2020-06-10,30,639,0,25,96,3145,0
Zapopan,2020-06-11,24,663,2,27,92,3237,0
Zapopan,2020-06-12,23,686,3,30,84,3321,0
Zapopan,2020-06-13,17,703,3,33,41,3362,0
Zapopan,2020-06-14,6,709,0,33,17,3379,0
Zapopan,2020-06-15,10,719,0,33,79,3458,0
Zapopan,2020-06-16,0,719,1,34,77,3535,0
Zapopan,2020-06-17,0,719,0,34,48,3583,0
Cuernavaca,2019-12-31,0,0,0,0,0,0,1
Cuernavaca,2020-01-01,0,0,0,0,0,0,1
Cuernavaca,2020-01-02,0,0,0,0,0,0,1
Cuernavaca,2020-01-03,0,0,0,0,0,0,1
Cuernavaca,2020-01-04,0,0,0,0,0,0,1
Cuernavaca,2020-01-05,0,0,0,0,0,0,1
Cuernavaca,2020-01-06,0,0,0,0,0,0,1
Cuernavaca,2020-01-07,0,0,0,0,0,0,1
Cuernavaca,2020-01-08,0,0,0,0,0,0,1
Cuernavaca,2020-01-09,0,0,0,0,0,0,1
Cuernavaca,2020-01-10,0,0,0,0,0,0,1
Cuernavaca,2020-01-11,0,0,0,0,0,0,1
Cuernavaca,2020-01-12,0,0,0,0,0,0,1
Cuernavaca,2020-01-13,0,0,0,0,1,1,1
Cuernavaca,2020-01-14,0,0,0,0,0,1,1
Cuernavaca,2020-01-15,0,0,0,0,0,1,1
Cuernavaca,2020-01-16,0,0,0,0,0,1,1
Cuernavaca,2020-01-17,0,0,0,0,0,1,1
Cuernavaca,2020-01-18,0,0,0,0,0,1,1
Cuernavaca,2020-01-19,0,0,0,0,0,1,1
Cuernavaca,2020-01-20,0,0,0,0,0,1,1
Cuernavaca,2020-01-21,0,0,0,0,0,1,1
Cuernavaca,2020-01-22,0,0,0,0,0,1,1
Cuernavaca,2020-01-23,0,0,0,0,0,1,1
Cuernavaca,2020-01-24,0,0,0,0,0,1,1
Cuernavaca,2020-01-25,0,0,0,0,0,1,1
Cuernavaca,2020-01-26,0,0,0,0,0,1,1
Cuernavaca,2020-01-27,0,0,0,0,0,1,1
Cuernavaca,2020-01-28,0,0,0,0,0,1,1
Cuernavaca,2020-01-29,0,0,0,0,0,1,1
Cuernavaca,2020-01-30,0,0,0,0,0,1,1
Cuernavaca,2020-01-31,0,0,0,0,0,1,1
Cuernavaca,2020-02-01,0,0,0,0,0,1,1
Cuernavaca,2020-02-02,0,0,0,0,0,1,1
Cuernavaca,2020-02-03,0,0,0,0,0,1,1
Cuernavaca,2020-02-04,0,0,0,0,0,1,1
Cuernavaca,2020-02-05,0,0,0,0,0,1,1
Cuernavaca,2020-02-06,0,0,0,0,0,1,1
Cuernavaca,2020-02-07,0,0,0,0,1,2,1
Cuernavaca,2020-02-08,0,0,0,0,0,2,1
Cuernavaca,2020-02-09,0,0,0,0,0,2,1
Cuernavaca,2020-02-10,0,0,0,0,0,2,1
Cuernavaca,2020-02-11,0,0,0,0,0,2,1
Cuernavaca,2020-02-12,0,0,0,0,0,2,1
Cuernavaca,2020-02-13,0,0,0,0,0,2,1
Cuernavaca,2020-02-14,0,0,0,0,0,2,1
Cuernavaca,2020-02-15,0,0,0,0,0,2,1
Cuernavaca,2020-02-16,0,0,0,0,0,2,1
Cuernavaca,2020-02-17,0,0,0,0,0,2,1
Cuernavaca,2020-02-18,0,0,0,0,0,2,1
Cuernavaca,2020-02-19,0,0,0,0,0,2,1
Cuernavaca,2020-02-20,0,0,0,0,0,2,1
Cuernavaca,2020-02-21,0,0,0,0,0,2,1
Cuernavaca,2020-02-22,0,0,0,0,0,2,1
Cuernavaca,2020-02-23,0,0,0,0,0,2,1
Cuernavaca,2020-02-24,0,0,0,0,0,2,1
Cuernavaca,2020-02-25,0,0,0,0,0,2,1
Cuernavaca,2020-02-26,0,0,0,0,0,2,1
Cuernavaca,2020-02-27,0,0,0,0,0,2,1
Cuernavaca,2020-02-28,0,0,0,0,0,2,1
Cuernavaca,2020-02-29,0,0,0,0,0,2,1
Cuernavaca,2020-03-01,0,0,0,0,1,3,1
Cuernavaca,2020-03-02,0,0,0,0,0,3,1
Cuernavaca,2020-03-03,0,0,0,0,0,3,1
Cuernavaca,2020-03-04,0,0,0,0,0,3,1
Cuernavaca,2020-03-05,0,0,0,0,0,3,1
Cuernavaca,2020-03-06,0,0,0,0,0,3,1
Cuernavaca,2020-03-07,0,0,0,0,0,3,1
Cuernavaca,2020-03-08,0,0,0,0,0,3,1
Cuernavaca,2020-03-09,0,0,0,0,0,3,1
Cuernavaca,2020-03-10,0,0,0,0,0,3,1
Cuernavaca,2020-03-11,0,0,0,0,0,3,1
Cuernavaca,2020-03-12,0,0,0,0,1,4,1
Cuernavaca,2020-03-13,0,0,0,0,0,4,1
Cuernavaca,2020-03-14,1,1,0,0,2,6,1
Cuernavaca,2020-03-15,0,1,0,0,0,6,1
Cuernavaca,2020-03-16,0,1,0,0,0,6,1
Cuernavaca,2020-03-17,0,1,0,0,1,7,1
Cuernavaca,2020-03-18,0,1,0,0,1,8,1
Cuernavaca,2020-03-19,0,1,0,0,4,12,1
Cuernavaca,2020-03-20,1,2,0,0,4,16,1
Cuernavaca,2020-03-21,0,2,0,0,0,16,1
Cuernavaca,2020-03-22,0,2,0,0,1,17,1
Cuernavaca,2020-03-23,2,4,0,0,9,26,1
Cuernavaca,2020-03-24,3,7,0,0,7,33,1
Cuernavaca,2020-03-25,0,7,0,0,7,40,1
Cuernavaca,2020-03-26,0,7,0,0,3,43,1
Cuernavaca,2020-03-27,0,7,0,0,3,46,1
Cuernavaca,2020-03-28,0,7,0,0,3,49,1
Cuernavaca,2020-03-29,1,8,1,1,7,56,1
Cuernavaca,2020-03-30,1,9,0,1,3,59,1
Cuernavaca,2020-03-31,0,9,1,2,4,63,1
Cuernavaca,2020-04-01,2,11,0,2,12,75,1
Cuernavaca,2020-04-02,2,13,0,2,6,81,1
Cuernavaca,2020-04-03,0,13,0,2,3,84,1
Cuernavaca,2020-04-04,3,16,0,2,9,93,1
Cuernavaca,2020-04-05,1,17,0,2,4,97,1
Cuernavaca,2020-04-06,2,19,0,2,9,106,1
Cuernavaca,2020-04-07,2,21,0,2,4,110,1
Cuernavaca,2020-04-08,3,24,0,2,13,123,1
Cuernavaca,2020-04-09,0,24,0,2,2,125,1
Cuernavaca,2020-04-10,0,24,0,2,4,129,1
Cuernavaca,2020-04-11,0,24,0,2,5,134,1
Cuernavaca,2020-04-12,1,25,0,2,3,137,1
Cuernavaca,2020-04-13,2,27,1,3,10,147,1
Cuernavaca,2020-04-14,4,31,0,3,12,159,1
Cuernavaca,2020-04-15,7,38,0,3,16,175,1
Cuernavaca,2020-04-16,1,39,0,3,6,181,1
Cuernavaca,2020-04-17,3,42,2,5,6,187,1
Cuernavaca,2020-04-18,3,45,0,5,4,191,0
Cuernavaca,2020-04-19,9,54,1,6,12,203,0
Cuernavaca,2020-04-20,13,67,3,9,22,225,0
Cuernavaca,2020-04-21,5,72,3,12,12,237,0
Cuernavaca,2020-04-22,14,86,1,13,18,255,0
Cuernavaca,2020-04-23,17,103,3,16,20,275,0
Cuernavaca,2020-04-24,9,112,1,17,10,285,0
Cuernavaca,2020-04-25,3,115,4,21,4,289,0
Cuernavaca,2020-04-26,16,131,3,24,19,308,0
Cuernavaca,2020-04-27,15,146,1,25,18,326,0
Cuernavaca,2020-04-28,8,154,1,26,14,340,0
Cuernavaca,2020-04-29,12,166,5,31,20,360,0
Cuernavaca,2020-04-30,11,177,0,31,23,383,0
Cuernavaca,2020-05-01,2,179,7,38,6,389,0
Cuernavaca,2020-05-02,6,185,1,39,6,395,0
Cuernavaca,2020-05-03,17,202,2,41,22,417,0
Cuernavaca,2020-05-04,7,209,4,45,14,431,0
Cuernavaca,2020-05-05,12,221,3,48,13,444,0
Cuernavaca,2020-05-06,14,235,3,51,30,474,0
Cuernavaca,2020-05-07,16,251,5,56,27,501,0
Cuernavaca,2020-05-08,7,258,3,59,15,516,0
Cuernavaca,2020-05-09,5,263,6,65,10,526,0
Cuernavaca,2020-05-10,7,270,2,67,10,536,0
Cuernavaca,2020-05-11,9,279,1,68,18,554,0
Cuernavaca,2020-05-12,7,286,4,72,19,573,0
Cuernavaca,2020-05-13,13,299,1,73,20,593,0
Cuernavaca,2020-05-14,3,302,0,73,14,607,0
Cuernavaca,2020-05-15,7,309,0,73,27,634,0
Cuernavaca,2020-05-16,1,310,2,75,2,636,0
Cuernavaca,2020-05-17,0,310,3,78,5,641,0
Cuernavaca,2020-05-18,10,320,1,79,23,664,0
Cuernavaca,2020-05-19,12,332,1,80,25,689,0
Cuernavaca,2020-05-20,9,341,1,81,18,707,0
Cuernavaca,2020-05-21,5,346,3,84,15,722,0
Cuernavaca,2020-05-22,8,354,3,87,17,739,0
Cuernavaca,2020-05-23,2,356,1,88,3,742,0
Cuernavaca,2020-05-24,1,357,0,88,3,745,0
Cuernavaca,2020-05-25,8,365,0,88,17,762,0
Cuernavaca,2020-05-26,7,372,0,88,27,789,0
Cuernavaca,2020-05-27,7,379,0,88,17,806,0
Cuernavaca,2020-05-28,8,387,0,88,17,823,0
Cuernavaca,2020-05-29,3,390,0,88,14,837,0
Cuernavaca,2020-05-30,6,396,0,88,9,846,0
Cuernavaca,2020-05-31,2,398,0,88,2,848,0
Cuernavaca,2020-06-01,11,409,0,88,30,878,0
Cuernavaca,2020-06-02,5,414,0,88,14,892,0
Cuernavaca,2020-06-03,9,423,0,88,18,910,0
Cuernavaca,2020-06-04,6,429,0,88,14,924,0
Cuernavaca,2020-06-05,8,437,1,89,17,941,0
Cuernavaca,2020-06-06,1,438,1,90,4,945,0
Cuernavaca,2020-06-07,2,440,0,90,4,949,0
Cuernavaca,2020-06-08,11,451,0,90,20,969,0
Cuernavaca,2020-06-09,11,462,3,93,25,994,0
Cuernavaca,2020-06-10,8,470,1,94,29,1023,0
Cuernavaca,2020-06-11,8,478,0,94,39,1062,0
Cuernavaca,2020-06-12,4,482,1,95,15,1077,0
Cuernavaca,2020-06-13,2,484,0,95,6,1083,0
Cuernavaca,2020-06-14,2,486,1,96,6,1089,0
Cuernavaca,2020-06-15,6,492,0,96,23,1112,0
Cuernavaca,2020-06-16,0,492,0,96,22,1134,0
Cuernavaca,2020-06-17,0,492,0,96,5,1139,0
Chihuahua,2019-12-31,0,0,0,0,0,0,1
Chihuahua,2020-01-01,0,0,0,0,0,0,1
Chihuahua,2020-01-02,0,0,0,0,0,0,1
Chihuahua,2020-01-03,0,0,0,0,0,0,1
Chihuahua,2020-01-04,0,0,0,0,0,0,1
Chihuahua,2020-01-05,0,0,0,0,0,0,1
Chihuahua,2020-01-06,0,0,0,0,0,0,1
Chihuahua,2020-01-07,0,0,0,0,0,0,1
Chihuahua,2020-01-08,0,0,0,0,0,0,1
Chihuahua,2020-01-09,0,0,0,0,0,0,1
Chihuahua,2020-01-10,0,0,0,0,0,0,1
Chihuahua,2020-01-11,0,0,0,0,0,0,1
Chihuahua,2020-01-12,0,0,0,0,0,0,1
Chihuahua,2020-01-13,0,0,0,0,0,0,1
Chihuahua,2020-01-14,0,0,0,0,0,0,1
Chihuahua,2020-01-15,0,0,0,0,0,0,1
Chihuahua,2020-01-16,0,0,0,0,0,0,1
Chihuahua,2020-01-17,0,0,0,0,0,0,1
Chihuahua,2020-01-18,0,0,0,0,0,0,1
Chihuahua,2020-01-19,0,0,0,0,0,0,1
Chihuahua,2020-01-20,0,0,0,0,0,0,1
Chihuahua,2020-01-21,0,0,0,0,0,0,1
Chihuahua,2020-01-22,0,0,0,0,0,0,1
Chihuahua,2020-01-23,0,0,0,0,0,0,1
Chihuahua,2020-01-24,0,0,0,0,0,0,1
Chihuahua,2020-01-25,0,0,0,0,0,0,1
Chihuahua,2020-01-26,0,0,0,0,0,0,1
Chihuahua,2020-01-27,0,0,0,0,0,0,1
Chihuahua,2020-01-28,0,0,0,0,0,0,1
Chihuahua,2020-01-29,0,0,0,0,0,0,1
Chihuahua,2020-01-30,0,0,0,0,0,0,1
Chihuahua,2020-01-31,0,0,0,0,0,0,1
Chihuahua,2020-02-01,0,0,0,0,0,0,1
Chihuahua,2020-02-02,0,0,0,0,0,0,1
Chihuahua,2020-02-03,0,0,0,0,0,0,1
Chihuahua,2020-02-04,0,0,0,0,0,0,1
Chihuahua,2020-02-05,0,0,0,0,0,0,1
Chihuahua,2020-02-06,0,0,0,0,0,0,1
Chihuahua,2020-02-07,0,0,0,0,0,0,1
Chihuahua,2020-02-08,0,0,0,0,0,0,1
Chihuahua,2020-02-09,0,0,0,0,0,0,1
Chihuahua,2020-02-10,0,0,0,0,0,0,1
Chihuahua,2020-02-11,0,0,0,0,0,0,1
Chihuahua,2020-02-12,0,0,0,0,0,0,1
Chihuahua,2020-02-13,0,0,0,0,0,0,1
Chihuahua,2020-02-14,0,0,0,0,0,0,1
Chihuahua,2020-02-15,0,0,0,0,0,0,1
Chihuahua,2020-02-16,0,0,0,0,0,0,1
Chihuahua,2020-02-17,0,0,0,0,0,0,1
Chihuahua,2020-02-18,0,0,0,0,0,0,1
Chihuahua,2020-02-19,0,0,0,0,0,0,1
Chihuahua,2020-02-20,0,0,0,0,0,0,1
Chihuahua,2020-02-21,0,0,0,0,0,0,1
Chihuahua,2020-02-22,0,0,0,0,0,0,1
Chihuahua,2020-02-23,0,0,0,0,0,0,1
Chihuahua,2020-02-24,0,0,0,0,0,0,1
Chihuahua,2020-02-25,0,0,0,0,0,0,1
Chihuahua,2020-02-26,0,0,0,0,1,1,1
Chihuahua,2020-02-27,0,0,0,0,0,1,1
Chihuahua,2020-02-28,0,0,0,0,1,2,1
Chihuahua,2020-02-29,0,0,0,0,0,2,1
Chihuahua,2020-03-01,0,0,0,0,0,2,1
Chihuahua,2020-03-02,0,0,0,0,0,2,1
Chihuahua,2020-03-03,0,0,0,0,1,3,1
Chihuahua,2020-03-04,0,0,0,0,0,3,1
Chihuahua,2020-03-05,0,0,0,0,0,3,1
Chihuahua,2020-03-06,0,0,0,0,0,3,1
Chihuahua,2020-03-07,0,0,0,0,1,4,1
Chihuahua,2020-03-08,0,0,0,0,0,4,1
Chihuahua,2020-03-09,0,0,0,0,0,4,1
Chihuahua,2020-03-10,0,0,0,0,1,5,1
Chihuahua,2020-03-11,0,0,0,0,0,5,1
Chihuahua,2020-03-12,0,0,0,0,0,5,1
Chihuahua,2020-03-13,1,1,0,0,1,6,1
Chihuahua,2020-03-14,0,1,0,0,0,6,1
Chihuahua,2020-03-15,0,1,0,0,2,8,1
Chihuahua,2020-03-16,0,1,0,0,0,8,1
Chihuahua,2020-03-17,0,1,0,0,1,9,1
Chihuahua,2020-03-18,0,1,0,0,0,9,1
Chihuahua,2020-03-19,1,2,0,0,2,11,1
Chihuahua,2020-03-20,0,2,0,0,2,13,1
Chihuahua,2020-03-21,1,3,0,0,1,14,1
Chihuahua,2020-03-22,0,3,0,0,5,19,1
Chihuahua,2020-03-23,0,3,0,0,3,22,1
Chihuahua,2020-03-24,0,3,0,0,1,23,1
Chihuahua,2020-03-25,0,3,0,0,3,26,1
Chihuahua,2020-03-26,0,3,0,0,2,28,1
Chihuahua,2020-03-27,0,3,0,0,2,30,1
Chihuahua,2020-03-28,0,3,0,0,3,33,1
Chihuahua,2020-03-29,1,4,0,0,2,35,1
Chihuahua,2020-03-30,1,5,0,0,7,42,1
Chihuahua,2020-03-31,0,5,0,0,2,44,1
Chihuahua,2020-04-01,2,7,0,0,2,46,1
Chihuahua,2020-04-02,1,8,0,0,3,49,1
Chihuahua,2020-04-03,1,9,0,0,5,54,1
Chihuahua,2020-04-04,1,10,0,0,3,57,1
Chihuahua,2020-04-05,4,14,0,0,7,64,1
Chihuahua,2020-04-06,4,18,0,0,11,75,1
Chihuahua,2020-04-07,2,20,1,1,7,82,1
Chihuahua,2020-04-08,1,21,1,2,7,89,1
Chihuahua,2020-04-09,1,22,0,2,9,98,1
Chihuahua,2020-04-10,3,25,0,2,7,105,1
Chihuahua,2020-04-11,4,29,0,2,9,114,1
Chihuahua,2020-04-12,0,29,2,4,0,114,1
Chihuahua,2020-04-13,2,31,1,5,19,133,1
Chihuahua,2020-04-14,3,34,0,5,15,148,1
Chihuahua,2020-04-15,3,37,0,5,12,160,1
Chihuahua,2020-04-16,6,43,0,5,16,176,1
Chihuahua,2020-04-17,5,48,0,5,12,188,1
Chihuahua,2020-04-18,4,52,0,5,9,197,0
Chihuahua,2020-04-19,3,55,0,5,8,205,0
Chihuahua,2020-04-20,5,60,2,7,22,227,0
Chihuahua,2020-04-21,7,67,2,9,21,248,0
Chihuahua,2020-04-22,6,73,1,10,16,264,0
Chihuahua,2020-04-23,11,84,0,10,29,293,0
Chihuahua,2020-04-24,18,102,2,12,34,327,0
Chihuahua,2020-04-25,6,108,1,13,20,347,0
Chihuahua,2020-04-26,4,112,3,16,10,357,0
Chihuahua,2020-04-27,11,123,1,17,28,385,0
Chihuahua,2020-04-28,31,154,0,17,47,432,0
Chihuahua,2020-04-29,13,167,3,20,25,457,0
Chihuahua,2020-04-30,15,182,1,21,28,485,0
Chihuahua,2020-05-01,15,197,2,23,35,520,0
Chihuahua,2020-05-02,15,212,2,25,28,548,0
Chihuahua,2020-05-03,5,217,1,26,12,560,0
Chihuahua,2020-05-04,12,229,4,30,32,592,0
Chihuahua,2020-05-05,14,243,1,31,47,639,0
Chihuahua,2020-05-06,10,253,2,33,50,689,0
Chihuahua,2020-05-07,11,264,2,35,49,738,0
Chihuahua,2020-05-08,14,278,2,37,32,770,0
Chihuahua,2020-05-09,12,290,1,38,28,798,0
Chihuahua,2020-05-10,5,295,0,38,14,812,0
Chihuahua,2020-05-11,16,311,0,38,43,855,0
Chihuahua,2020-05-12,7,318,1,39,36,891,0
Chihuahua,2020-05-13,7,325,0,39,33,924,0
Chihuahua,2020-05-14,11,336,0,39,40,964,0
Chihuahua,2020-05-15,17,353,1,40,41,1005,0
Chihuahua,2020-05-16,9,362,1,41,29,1034,0
Chihuahua,2020-05-17,1,363,1,42,11,1045,0
Chihuahua,2020-05-18,4,367,1,43,31,1076,0
Chihuahua,2020-05-19,5,372,1,44,21,1097,0
Chihuahua,2020-05-20,4,376,0,44,21,1118,0
Chihuahua,2020-05-21,5,381,0,44,37,1155,0
Chihuahua,2020-05-22,11,392,0,44,30,1185,0
Chihuahua,2020-05-23,5,397,0,44,11,1196,0
Chihuahua,2020-05-24,7,404,1,45,18,1214,0
Chihuahua,2020-05-25,10,414,0,45,32,1246,0
Chihuahua,2020-05-26,5,419,2,47,26,1272,0
Chihuahua,2020-05-27,6,425,1,48,32,1304,0
Chihuahua,2020-05-28,6,431,1,49,30,1334,0
Chihuahua,2020-05-29,10,441,0,49,28,1362,0
Chihuahua,2020-05-30,1,442,0,49,11,1373,0
Chihuahua,2020-05-31,1,443,1,50,15,1388,0
Chihuahua,2020-06-01,6,449,1,51,42,1430,0
Chihuahua,2020-06-02,13,462,1,52,44,1474,0
Chihuahua,2020-06-03,5,467,1,53,19,1493,0
Chihuahua,2020-06-04,3,470,1,54,24,1517,0
Chihuahua,2020-06-05,11,481,0,54,24,1541,0
Chihuahua,2020-06-06,5,486,0,54,14,1555,0
Chihuahua,2020-06-07,7,493,0,54,15,1570,0
Chihuahua,2020-06-08,12,505,2,56,29,1599,0
Chihuahua,2020-06-09,15,520,1,57,38,1637,0
Chihuahua,2020-06-10,11,531,0,57,31,1668,0
Chihuahua,2020-06-11,9,540,0,57,32,1700,0
Chihuahua,2020-06-12,3,543,0,57,15,1715,0
Chihuahua,2020-06-13,1,544,0,57,8,1723,0
Chihuahua,2020-06-14,1,545,0,57,12,1735,0
Chihuahua,2020-06-15,0,545,0,57,20,1755,0
Chihuahua,2020-06-16,0,545,0,57,34,1789,0
Chihuahua,2020-06-17,0,545,1,58,6,1795,0
